wwwwwwwwwwwww
w  w    w   w
w -www ww-w w
w-ww      w-w
w w w-wwwww w
w - -       w
w w www w - w
w w w       w
www w w - w w
w           w
wwww-wwww   w
w       -   w
wwwwwwwwwwwww