wwwwwwwwwwwww
w   -   w   w
ww-www-ww-w w
w--w  e   w-w
w w w-www-w w
we- - -     w
w w www w -ww
w w w       w
www w w - www
we   e    - w
ww  -wwww - w
we      -   w
wwwwwwwwwwwww
