wwwwwwwwwwwww
w   w   w   w
ww www-ww-w w
w -w  e   w-w
w wцw-www-w w
we- - - w   w
w w www w -ww
w w w       w
w-w www---www
we   e    - w
w-wwwwwwwww w
we      -   w
wwwwwwwwwwwww
